zaaaaa
 -- --
b ffxx
bbffxx
bbb@xx
---1--