m  4  f----5b   
        --      
---2---    --3- 
  -@        -    
         --      
 --- --   --- -  
a       ---     x
        - -      