#########
#c   pll#
#       #
# m  @ s#
#####1###